111111111111
1101000000C1
1C00011010P1
11010E001001
111111111111
